1 1 1 1 1 1 1 1 1 1 1 1 1 1 1 1 1 1 1 1 1 1 1 1 1 1 1 1 1 1 1 1 1 1 1 1 1 1 1 1 1 1 1 1 1 1 1 1 1 1
1 2 2 2 2 2 2 2 2 2 2 2 2 2 2 2 2 2 2 2 2 2 2 2 2 2 2 2 2 2 2 2 2 2 2 2 2 2 2 2 2 2 2 2 2 2 2 2 2 1
1 2 2 2 2 2 2 2 2 2 2 2 3 3 3 3 3 3 3 3 3 3 3 3 3 3 3 3 3 3 3 3 3 3 3 3 3 2 2 2 2 2 2 2 2 2 2 2 2 1
1 2 2 2 2 2 2 2 2 2 3 3 3 3 3 3 0 0 0 0 0 0 0 0 0 0 0 0 0 0 0 0 0 0 0 0 3 3 3 3 2 2 2 2 2 2 2 2 2 1
1 2 2 2 2 2 3 3 3 3 3 0 0 0 0 0 0 0 0 0 0 0 0 0 0 0 0 0 0 0 0 0 0 0 0 0 0 0 0 3 3 2 2 2 2 2 2 2 2 1
1 2 2 2 2 3 3 0 0 0 0 0 0 0 0 0 0 0 0 0 0 0 0 0 0 0 0 0 0 0 0 5 5 5 5 5 0 0 0 0 3 3 3 2 2 2 2 2 2 1
1 2 2 2 2 3 0 0 0 0 0 0 0 0 0 0 0 0 0 0 0 0 0 0 0 0 0 0 0 3 3 3 3 3 3 3 3 3 0 0 0 0 3 3 2 2 2 2 2 1
1 2 2 2 2 3 3 0 0 0 0 0 0 0 0 0 0 0 0 0 0 5 5 0 0 0 0 0 0 3 3 3 3 3 3 3 3 3 0 0 0 0 0 3 3 2 2 2 2 1
1 2 2 2 2 2 3 3 3 0 0 0 0 0 0 0 0 0 0 0 0 0 4 5 5 0 0 0 0 3 3 3 3 3 3 3 3 3 0 0 0 0 0 0 3 2 2 2 2 1
1 2 2 2 2 2 3 3 3 0 0 0 0 0 0 0 0 0 0 0 0 0 0 5 0 0 0 0 0 3 3 3 3 3 3 3 3 3 0 0 0 0 0 0 3 2 2 2 2 1
1 2 2 2 2 3 3 3 3 0 0 0 0 0 0 0 5 0 0 0 0 0 0 5 0 0 0 0 0 5 3 3 3 3 3 3 3 3 0 0 0 0 0 0 3 2 2 2 2 1
1 2 2 2 3 3 3 3 3 0 0 0 0 0 0 5 2 5 0 0 0 0 0 5 6 6 6 6 0 0 0 5 5 5 5 5 5 0 0 0 0 0 0 0 3 2 2 2 2 1
1 2 2 2 3 3 3 0 0 0 0 0 0 0 0 0 5 0 0 0 0 0 0 5 6 6 6 6 0 0 0 0 4 4 4 4 4 4 0 0 0 3 3 3 3 2 2 2 2 1
1 2 2 2 3 3 0 0 0 0 0 0 0 0 0 0 0 0 0 0 0 0 0 5 0 0 0 0 0 0 0 4 4 4 4 4 4 0 0 0 0 3 3 3 2 2 2 2 2 1
1 2 2 2 3 0 0 0 0 0 0 0 6 6 6 0 0 0 0 0 0 0 0 5 0 4 0 4 0 0 4 4 4 4 4 4 4 4 0 0 0 3 3 2 2 2 2 2 2 1
1 2 2 2 3 0 0 0 0 0 0 6 4 4 4 6 0 0 0 0 0 0 0 5 0 0 4 0 4 6 6 4 4 4 4 4 4 0 0 0 0 3 3 2 2 2 2 2 2 1
1 2 2 2 3 0 0 0 0 0 6 4 4 4 4 4 6 0 0 0 0 0 0 5 4 4 4 0 6 6 6 6 4 4 4 4 4 0 0 0 0 3 3 2 2 2 2 2 2 1
1 2 2 2 3 0 0 0 0 0 6 4 4 4 4 4 6 0 0 0 0 0 0 5 0 4 4 6 6 6 6 6 4 4 4 4 4 4 0 0 0 3 3 2 2 2 2 2 2 1
1 2 2 2 3 0 0 0 0 0 0 6 4 4 4 6 0 0 6 6 0 0 0 5 0 0 0 6 6 6 6 6 4 4 4 4 4 4 0 0 0 3 3 3 2 2 2 2 2 1
1 2 2 3 3 0 0 0 0 0 0 0 0 6 6 0 0 6 6 6 0 0 0 5 0 0 0 0 6 6 6 6 6 4 4 4 4 0 0 0 0 0 3 3 2 2 2 2 2 1
1 2 2 3 0 0 0 0 0 0 0 0 0 0 0 0 6 6 0 0 0 0 0 5 0 0 0 0 0 6 0 6 0 0 4 0 4 0 0 0 0 0 0 3 2 2 2 2 2 1
1 2 2 3 0 0 0 0 0 0 0 0 0 0 0 0 6 6 0 0 0 0 0 5 0 0 0 0 0 0 0 0 0 0 0 0 0 0 0 0 0 0 0 3 2 2 2 2 2 1
1 2 2 3 0 0 0 0 0 0 0 0 0 0 0 0 0 0 0 0 0 5 0 5 0 0 0 0 0 0 0 0 0 0 0 0 0 0 0 0 0 0 3 3 2 2 2 2 2 1
1 2 2 3 0 0 0 0 0 0 0 0 0 0 0 0 4 0 0 0 0 0 0 5 0 0 0 0 0 0 0 0 0 0 0 0 0 0 0 0 0 0 3 3 2 2 2 2 2 1
1 2 2 3 3 0 0 0 0 0 0 0 0 0 0 0 0 0 0 0 0 0 0 5 0 0 0 0 0 0 0 0 0 0 0 0 0 0 0 0 0 0 3 3 2 2 2 2 2 1
1 2 2 2 3 0 0 0 0 0 0 0 4 0 0 0 0 0 0 0 0 0 0 5 0 0 0 0 0 0 0 0 0 0 0 0 0 0 0 0 0 3 3 3 2 2 2 2 2 1
1 2 2 2 3 0 0 0 0 0 0 0 0 0 0 0 0 0 0 4 4 0 0 5 0 0 0 0 0 2 2 0 0 0 0 0 0 0 3 3 3 3 3 2 2 2 2 2 2 1
1 2 2 2 3 3 0 0 0 0 0 0 0 0 0 0 0 0 0 0 0 0 6 5 0 0 0 0 0 5 2 0 0 0 0 0 0 0 3 2 2 2 2 2 2 2 2 2 2 1
1 2 2 2 2 3 3 0 0 0 0 0 0 0 0 0 0 0 0 0 0 0 4 5 0 0 0 0 0 0 0 0 0 0 0 0 3 3 3 2 2 2 2 2 2 2 2 2 2 1
1 2 2 2 2 2 3 3 3 3 3 3 3 0 0 0 0 0 0 0 0 0 0 5 0 0 0 0 0 0 0 0 0 0 0 3 3 3 3 2 2 2 2 2 2 2 2 2 2 1
1 2 2 2 2 2 2 2 2 2 2 2 3 3 3 3 3 3 3 3 3 3 3 5 3 3 3 3 3 3 3 3 3 3 3 3 3 3 2 2 2 2 2 2 2 2 2 2 2 1
1 2 2 2 2 2 2 2 2 2 2 2 2 2 2 2 3 3 3 3 3 3 3 5 3 3 2 2 2 2 2 2 2 2 2 2 2 2 2 2 2 2 2 2 2 2 2 2 2 1
1 2 2 2 2 2 2 2 2 2 2 2 2 2 2 2 2 2 2 2 2 3 3 5 3 2 2 2 2 2 2 2 2 2 2 2 2 2 2 2 2 2 2 2 2 2 2 2 2 1
1 2 2 2 2 2 2 2 2 2 2 2 2 2 2 2 2 2 2 2 2 2 3 5 3 2 2 2 2 2 2 2 2 2 2 2 2 2 2 2 2 2 2 2 2 2 2 2 2 1
1 2 2 2 2 2 2 2 2 2 2 2 2 2 2 2 2 2 2 2 2 2 3 5 3 2 2 2 2 2 2 2 2 2 2 2 2 2 2 2 2 2 2 2 2 2 2 2 2 1
1 2 2 2 2 2 2 2 2 2 2 2 2 2 2 2 2 2 2 2 2 2 3 5 3 2 2 2 2 2 2 2 2 2 2 2 2 2 2 2 2 2 2 2 2 2 2 2 2 1
1 2 2 2 2 2 2 2 2 2 2 2 2 2 2 2 2 2 2 2 2 2 3 5 3 2 2 2 2 2 2 2 2 2 2 2 2 2 2 2 2 2 2 2 2 2 2 2 2 1
1 2 2 2 2 2 2 2 2 2 2 2 2 2 2 2 2 2 2 2 2 2 3 5 3 2 2 2 2 2 2 2 2 2 2 2 2 2 2 2 2 2 2 2 2 2 2 2 2 1
1 2 2 2 2 2 2 2 2 2 2 2 2 2 2 2 2 2 2 2 2 2 3 5 3 2 2 2 2 2 2 2 2 2 2 2 2 2 2 2 2 2 2 2 2 2 2 2 2 1
1 2 2 2 2 2 2 2 2 2 2 2 2 2 2 2 2 2 2 2 2 2 3 5 3 2 2 2 2 2 2 2 2 2 2 2 2 2 2 2 2 2 2 2 2 2 2 2 2 1
1 2 2 2 2 2 2 2 2 2 2 2 2 2 2 2 2 2 2 2 2 3 8 5 8 3 2 2 2 2 2 2 2 2 2 2 2 2 2 2 2 2 2 2 2 2 2 2 2 1
1 2 2 2 2 2 2 2 2 2 2 2 2 2 2 2 2 2 2 1 1 1 5 5 5 1 1 1 2 2 2 2 2 2 2 2 2 2 2 2 2 2 2 2 2 2 2 2 2 1
1 2 2 2 2 2 2 2 2 2 2 2 2 2 2 2 2 2 2 1 5 5 5 5 5 5 5 1 2 2 2 2 2 2 2 2 2 2 2 2 2 2 2 2 2 2 2 2 2 1
1 2 2 2 2 2 2 2 2 2 2 2 2 2 2 2 2 2 2 1 5 5 5 5 5 5 5 1 2 2 2 2 2 2 2 2 2 2 2 2 2 2 2 2 2 2 2 2 2 1
1 2 2 2 2 2 2 2 2 2 2 2 2 2 2 2 2 2 2 1 5 5 5 5 5 5 5 1 2 2 2 2 2 2 2 2 2 2 2 2 2 2 2 2 2 2 2 2 2 1
1 2 2 2 2 2 2 2 2 2 2 2 2 2 2 2 2 2 2 1 5 5 5 5 5 5 5 1 2 2 2 2 2 2 2 2 2 2 2 2 2 2 2 2 2 2 2 2 2 1
1 2 2 2 2 2 2 2 2 2 2 2 2 2 2 2 2 2 2 1 1 1 1 1 1 1 1 1 2 2 2 2 2 2 2 2 2 2 2 2 2 2 2 2 2 2 2 2 2 1
1 2 2 2 2 2 2 2 2 2 2 2 2 2 2 2 2 2 2 2 2 2 2 2 2 2 2 2 2 2 2 2 2 2 2 2 2 2 2 2 2 2 2 2 2 2 2 2 2 1
1 2 2 2 2 2 2 2 2 2 2 2 2 2 2 2 2 2 2 2 2 2 2 2 2 2 2 2 2 2 2 2 2 2 2 2 2 2 2 2 2 2 2 2 2 2 2 2 2 1
1 1 1 1 1 1 1 1 1 1 1 1 1 1 1 1 1 1 1 1 1 1 1 1 1 1 1 1 1 1 1 1 1 1 1 1 1 1 1 1 1 1 1 1 1 1 1 1 1 1